20
15
18
13
0 0 0 0 0 0 0 0 0 0 0 0 0 0 0 0 0 0 0 0
3 1 1 1 1 1 1 1 1 1 1 1 1 1 1 1 1 1 1 3
3 1 1 1 1 1 1 1 1 1 1 1 1 1 1 1 1 1 1 2
3 1 1 1 1 1 1 1 1 1 1 1 1 1 1 1 1 1 1 2
3 1 1 1 1 1 1 1 1 1 1 1 1 1 1 1 1 1 1 2
3 1 1 1 1 1 1 1 1 1 1 1 1 1 0 0 0 0 1 0
3 1 1 1 1 1 1 1 1 1 1 1 1 1 1 1 1 1 1 3
3 1 1 1 1 1 1 1 1 0 0 0 0 1 1 1 1 1 1 3
3 0 0 1 1 1 1 1 1 1 1 1 1 1 1 1 1 1 1 3 
3 1 1 1 1 1 1 1 1 1 1 1 1 1 1 1 1 1 1 3
3 0 0 0 0 0 0 1 1 1 1 1 1 1 1 1 1 1 1 3
3 1 1 1 1 1 1 1 1 1 1 1 1 1 1 1 1 1 1 3
3 1 1 1 1 1 1 1 1 1 1 1 0 0 0 1 1 1 1 3
3 4 4 4 4 4 4 1 1 1 1 1 1 1 1 1 1 1 1 3
3 0 0 0 0 0 0 0 0 0 0 0 0 0 0 0 0 0 0 3
