20
15
18
13
1 1 1 1 1 1 1 1 1 1 1 1 1 1 1 1 1 1 1 1 
2 0 0 0 0 0 0 0 0 0 0 0 0 0 0 0 0 0 0 2 
4 0 0 0 0 0 0 0 0 0 0 0 0 0 0 0 0 0 0 2 
3 0 0 0 0 0 0 0 0 0 0 0 0 0 0 0 0 0 0 2 
3 0 5 5 5 0 0 0 0 0 0 0 0 0 0 0 0 0 0 2 
4 0 0 0 0 0 0 0 0 0 0 0 0 0 0 0 0 0 0 2 
2 0 0 0 0 5 5 0 0 5 5 0 0 5 5 0 0 0 0 2 
2 0 0 0 0 0 0 0 0 0 0 0 0 0 0 0 0 0 0 2 
2 0 0 0 0 0 0 0 0 0 0 0 0 0 0 0 0 5 0 2 
2 0 0 0 0 5 5 5 7 7 5 5 7 7 5 5 0 0 0 2 
2 5 0 0 0 0 0 0 1 1 0 0 1 1 0 0 0 0 0 2 
2 0 5 0 0 0 0 0 0 0 0 0 0 0 0 0 0 0 0 2 
2 0 0 5 0 5 0 0 0 0 0 0 0 0 0 0 0 0 0 2 
2 0 0 0 7 0 7 5 0 5 7 5 7 5 7 5 0 0 0 2 
2 1 1 1 1 1 1 1 1 1 1 1 1 1 1 1 1 1 1 2 
