20
15
19
2
1 1 1 1 1 1 1 1 7 7 7 7 7 1 1 1 1 1 1 1 
2 0 0 7 0 0 0 0 1 1 1 1 1 0 0 0 0 0 0 2 
2 0 0 7 0 0 0 0 0 0 0 0 0 0 0 0 0 0 0 2 
2 0 0 7 0 0 1 1 1 1 0 0 0 0 0 0 0 0 0 2 
2 0 0 7 0 0 0 0 0 0 0 0 0 0 0 7 7 7 0 2 
2 0 0 7 0 1 1 1 0 0 0 0 0 0 0 0 0 0 0 2 
2 0 0 7 0 0 0 0 0 0 7 7 7 7 0 0 0 0 0 2 
2 0 0 7 0 0 4 0 4 0 0 0 0 0 0 0 1 1 1 2 
2 0 0 7 0 0 4 0 3 0 0 0 0 0 1 1 1 0 0 2 
2 0 0 7 0 0 0 0 3 0 0 0 1 1 1 0 0 0 0 2 
2 0 0 7 0 0 0 0 4 0 1 1 1 0 0 0 0 4 4 2 
2 0 0 7 0 0 0 0 1 1 1 0 0 0 0 0 0 3 3 2 
2 0 0 7 7 7 1 1 1 0 0 0 0 0 0 0 0 3 3 2 
2 7 7 7 1 1 1 7 7 7 7 7 7 7 7 7 7 4 4 2 
2 1 1 1 1 1 1 1 1 1 1 1 1 1 1 1 1 1 1 2 
