20
15
18
13
1 1 1 1 1 1 1 1 1 1 1 1 1 1 1 1 1 1 1 1 
2 0 0 0 0 0 0 0 0 0 0 0 0 0 0 0 0 0 0 2 
2 0 0 0 0 0 0 0 0 0 0 0 0 0 0 0 0 0 0 2 
2 0 0 0 0 0 0 0 0 0 0 0 0 0 0 0 0 0 0 2 
2 0 0 0 0 0 0 0 0 0 0 0 0 0 0 0 0 0 0 2 
2 0 0 0 0 0 0 0 0 0 0 0 0 0 0 0 0 0 0 4 
2 0 0 0 0 0 0 0 0 0 0 0 0 0 0 0 0 0 0 3 
2 0 0 0 0 0 0 0 0 6 6 0 0 0 6 0 6 0 0 3 
2 0 0 0 0 0 6 0 7 0 0 7 7 7 0 0 0 0 0 4 
2 0 0 0 6 0 0 0 1 0 0 1 1 1 0 0 0 0 0 2 
2 0 0 0 0 0 0 0 0 0 0 0 0 0 0 0 0 0 0 2 
2 0 6 0 0 6 6 0 0 0 0 0 0 0 0 0 0 0 0 2 
2 0 0 0 0 0 0 0 6 6 0 0 6 6 0 0 0 0 0 2 
2 0 0 0 0 0 0 7 0 0 7 7 0 0 7 7 6 0 0 2 
2 1 1 1 1 1 1 1 1 1 1 1 1 1 1 1 1 6 6 2 
