20
15
18
13
1 1 1 1 1 1 1 1 1 1 1 1 1 1 1 1 1 1 1 1 
2 0 0 0 0 0 0 0 0 0 0 0 0 0 0 0 0 0 0 2 
2 0 0 0 0 0 0 0 0 0 0 0 0 0 0 0 0 0 0 2 
2 0 0 0 0 0 0 0 0 0 0 0 0 0 0 0 0 0 0 2 
2 0 0 0 0 0 0 0 0 0 0 0 0 0 0 0 0 0 0 2 
2 0 0 0 0 0 0 0 0 0 0 0 0 0 0 0 0 0 0 2 
2 0 0 0 0 0 0 0 0 0 0 0 0 0 0 0 0 0 0 2 
2 0 0 0 0 0 0 0 0 0 0 0 0 0 0 0 0 0 0 2 
2 0 0 0 0 0 0 0 0 0 0 0 0 0 0 0 0 0 0 2 
2 0 0 0 0 0 0 0 0 0 0 0 0 0 0 0 0 0 0 2 
2 0 5 5 0 5 5 0 0 0 5 5 0 0 0 0 0 0 0 2 
2 0 0 0 0 5 0 0 0 0 0 0 0 0 0 0 0 0 0 2 
2 0 0 0 0 5 0 0 0 0 0 0 0 6 0 0 0 0 0 2 
2 0 0 0 0 5 0 0 0 7 7 7 7 7 7 5 0 0 0 2 
2 4 3 3 3 4 1 1 1 1 1 1 1 1 1 1 1 1 1 2 
