20
15
19
13
1 1 1 1 1 1 1 1 1 1 1 1 1 1 1 1 1 1 1 1 
2 0 0 0 0 0 0 0 0 0 0 0 0 0 0 0 0 0 0 2 
2 0 0 0 0 0 0 0 0 0 0 0 0 0 0 0 0 0 0 2 
2 0 0 0 0 0 0 0 0 0 0 0 0 0 0 0 0 0 0 2 
2 0 0 0 0 0 0 0 0 0 0 0 0 0 0 0 0 0 0 2 
2 0 0 0 0 0 0 0 0 0 0 0 0 0 0 0 0 0 0 2 
2 0 0 0 0 0 0 0 0 0 0 0 0 0 0 0 0 0 0 2 
2 0 0 0 0 0 0 0 0 0 0 0 0 0 0 0 0 0 0 2 
2 0 0 0 0 0 0 0 0 0 0 0 0 0 0 0 0 0 0 2 
2 0 0 0 0 0 0 0 0 0 0 0 0 0 0 0 0 0 0 2 
4 0 0 0 0 0 0 0 0 0 0 0 0 0 0 0 0 0 0 2 
3 0 0 0 0 0 0 0 0 0 0 0 0 0 0 0 0 0 0 2 
3 0 0 0 0 0 0 0 0 0 0 0 0 0 0 0 0 0 0 2 
4 0 0 0 0 0 0 0 0 0 0 0 0 0 0 0 0 0 0 2 
2 1 7 1 7 1 7 7 7 7 1 1 1 7 1 7 1 7 1 2 
